NO ./assets/textures/wall.xpm 
SO ./assets/textures/wall.xpm
WE ./assets/textures/wall.xpm
EA ./assets/textures/wall.xpm
     
F 234, 234, 234
C 1, 1, 1

SPN     6;
SPR	./assets/centipede.xpm, 26.5 4.5 1 1 1 1 60, 26.5 1.5 1 1 1 1 60
SPR	./assets/magic_circle.xpm, 25.3 6.5 1 1 1 1 60
SPR	./assets/magic_circle2.xpm, 20.5 7.5 1 1 2 2 60
SPR	./assets/white_crystal.xpm , 19.4 3.5 1 1 3 3 50
SPA	./assets/fire_camp.xpm , 27.5 11.5 64 64 1 1 200 4 6

        1111111111111111111111111
        1000000000110000000000001
        1011000001110000000000001
        100100000000000001D100001
111111111011000001110000010100001
10000000001100000111011111D111111
11110111111111000000000000001
11110111111111011101010010001
11000000110101011100000010001
100000000000000011000000D000 11
100000000000000011010100000001
1100000111010101111101111N0011
11110111 1110101 101111010001
11111111 1111111 011111111111
